1 1 1 1 1 1 1 1 1 1 1 1 1 1 1 1 1 1 1 1 1 1 1 1 1 1 1 1 1 1 1 1 1 1 1 1 1 1 1 1 1 1 1 1 1 1 1 1 1 1 1 1 1 1 1 1 1 1 1 1 1 1 1 1 1 1 1 1 1 1 1 1 1 1 1 1 1
1 1 1 1 1 1 1 1 1 1 1 1 1 1 1 1 1 1 1 1 1 1 1 1 1 1 1 1 1 1 1 1 1 1 1 1 1 1 1 1 1 1 1 1 1 1 1 1 1 1 1 1 1 1 1 1 1 1 1 1 1 1 1 1 1 1 1 1 1 1 1 1 1 1 1 1 1
1 1 1 1 1 1 1 1 1 1 1 1 1 1 1 1 1 1 1 1 1 1 1 1 1 1 1 1 1 1 1 1 1 1 1 1 1 1 1 1 1 1 1 1 1 1 1 1 1 1 1 1 1 1 1 1 1 1 1 1 1 1 1 1 1 1 1 1 1 1 1 1 1 1 1 1 1
1 1 1 1 1 1 1 1 1 1 1 1 1 1 1 1 1 1 1 1 1 1 1 1 1 1 1 1 1 1 1 1 1 1 1 1 1 1 1 1 1 1 1 1 1 1 1 1 1 1 1 1 1 1 1 1 1 1 1 1 1 1 1 1 1 1 1 1 1 1 1 1 1 1 1 1 1
1 1 1 1 1 1 1 1 1 1 1 1 1 1 1 1 1 1 1 1 1 1 1 1 1 1 1 1 1 1 1 1 1 1 1 1 1 1 1 1 1 1 1 1 1 1 1 1 1 1 1 1 1 1 1 1 1 1 1 1 1 1 1 1 1 1 1 1 1 1 1 1 1 1 1 1 1
1 1 1 1 1 1 1 1 1 1 1 1 1 1 1 1 1 1 1 1 1 1 1 1 1 1 1 1 1 1 4 4 4 4 4 4 4 4 4 4 4 4 4 4 4 4 4 1 1 1 1 1 1 1 1 1 1 1 1 1 1 1 1 1 1 1 1 1 1 1 1 1 1 1 1 1 1
1 1 1 1 1 1 1 1 1 1 1 1 1 1 1 1 1 1 1 1 1 1 1 1 1 1 1 1 1 1 4 2 2 2 2 2 2 2 2 2 2 2 2 2 2 2 4 1 1 1 1 1 1 1 1 1 1 1 1 1 1 1 1 1 1 1 1 1 1 1 1 1 1 1 1 1 1
1 1 1 1 1 1 1 1 1 1 1 1 1 1 1 1 1 1 1 1 1 1 1 1 1 1 1 1 1 1 4 2 2 2 2 2 2 2 2 2 2 2 2 2 2 2 4 1 1 1 1 1 1 1 1 1 1 1 1 1 1 1 1 1 1 1 1 1 1 1 1 1 1 1 1 1 1
1 1 1 1 1 1 1 1 1 1 1 1 1 1 1 1 1 1 1 1 1 1 1 1 1 1 1 1 1 1 4 2 2 2 2 2 2 2 2 2 2 2 2 2 2 2 4 1 1 1 1 1 1 1 1 1 1 1 1 1 1 1 1 1 1 1 1 1 1 1 1 1 1 1 1 1 1
1 1 1 1 1 1 1 1 1 1 1 1 1 1 1 1 1 1 1 1 1 1 1 1 1 1 1 1 1 1 4 2 2 2 2 2 2 2 2 2 2 2 2 2 2 2 4 1 1 1 1 1 1 1 1 1 1 1 1 1 1 1 1 1 1 1 1 1 1 1 1 1 1 1 1 1 1
1 1 1 1 1 1 1 1 1 1 1 1 1 1 1 1 1 1 1 1 1 1 1 1 1 1 1 1 1 1 4 2 2 2 2 2 2 2 2 2 2 2 2 2 2 2 4 1 1 1 1 1 1 1 1 1 1 1 1 1 1 1 1 1 1 1 1 1 1 1 1 1 1 1 1 1 1
1 1 1 1 1 1 1 1 1 1 1 1 1 1 1 1 1 1 1 1 1 1 1 1 1 1 1 1 1 1 4 2 2 2 2 2 2 2 2 2 2 2 2 2 2 2 4 1 1 1 1 1 1 1 1 1 1 1 1 1 1 1 1 1 1 1 1 1 1 1 1 1 1 1 1 1 1
1 1 1 1 1 1 1 1 1 1 1 1 1 1 1 1 1 1 1 1 1 1 1 1 1 1 1 1 1 1 4 2 2 2 2 2 2 2 2 2 2 2 2 2 2 2 4 1 1 1 1 1 1 1 1 1 1 1 1 1 1 1 1 1 1 1 1 1 1 1 1 1 1 1 1 1 1
1 1 1 1 1 1 1 1 1 1 1 1 1 1 1 1 1 1 1 1 1 1 1 1 1 1 1 1 1 1 4 2 2 2 2 2 2 2 2 2 2 2 2 2 2 2 4 1 1 1 1 1 1 1 1 1 1 1 1 1 1 1 1 1 1 1 1 1 1 1 1 1 1 1 1 1 1
1 1 1 1 1 1 1 1 1 1 1 1 1 1 1 1 1 1 1 1 1 1 1 1 1 1 1 1 1 1 4 2 2 2 2 2 2 2 2 2 2 2 2 2 2 2 4 1 1 1 1 1 1 1 1 1 1 1 1 1 1 1 1 1 1 1 1 1 1 1 1 1 1 1 1 1 1
1 1 1 1 1 1 1 1 1 1 1 1 1 1 1 1 1 1 1 1 1 1 1 1 1 1 1 1 1 1 4 2 2 2 2 2 2 2 2 2 2 2 2 2 2 2 4 1 1 1 1 1 1 1 1 1 1 1 1 1 1 1 1 1 1 1 1 1 1 1 1 1 1 1 1 1 1
1 1 1 1 1 1 1 1 1 1 1 1 1 1 1 1 1 1 1 1 1 1 1 1 1 1 1 1 1 1 4 2 2 2 2 2 2 2 2 2 2 2 2 2 2 2 4 1 1 1 1 1 1 1 1 1 1 1 1 1 1 1 1 1 1 1 1 1 1 1 1 1 1 1 1 1 1
1 1 1 1 1 1 1 1 1 1 1 1 1 1 1 1 1 1 1 1 1 1 1 1 1 1 1 1 1 1 4 2 2 2 2 2 2 2 2 2 2 2 2 2 2 2 4 1 1 1 1 1 1 1 1 1 1 1 1 1 1 1 1 1 1 1 1 1 1 1 1 1 1 1 1 1 1
1 1 1 1 1 1 1 1 1 1 1 1 1 1 1 1 1 1 1 1 1 1 1 1 1 1 1 1 1 1 4 2 2 2 2 2 2 2 2 2 2 2 2 2 2 2 4 1 1 1 1 1 1 1 1 1 1 1 1 1 1 1 1 1 1 1 1 1 1 1 1 1 1 1 1 1 1
1 1 1 1 1 1 1 1 1 1 1 1 1 1 1 1 1 1 1 1 1 1 1 1 1 1 1 1 1 1 4 2 2 2 2 2 2 2 2 2 2 2 2 2 2 2 4 1 1 1 1 1 1 1 1 1 1 1 1 1 1 1 1 1 1 1 1 1 1 1 1 1 1 1 1 1 1
1 1 1 1 1 1 1 1 1 1 1 1 1 1 1 1 1 1 1 1 1 1 1 1 1 1 1 1 1 1 4 2 2 2 2 2 2 2 2 2 2 2 2 2 2 2 4 1 1 1 1 1 1 1 1 1 1 1 1 1 1 1 1 1 1 1 1 1 1 1 1 1 1 1 1 1 1
1 1 1 1 1 1 1 1 1 1 1 1 1 1 1 1 1 1 1 1 1 1 1 1 1 1 1 1 1 1 4 2 2 2 2 2 2 2 2 2 2 2 2 2 2 2 4 1 1 1 1 1 1 1 1 1 1 1 1 1 1 1 1 1 1 1 1 1 1 1 1 1 1 1 1 1 1
1 1 1 1 1 1 1 1 1 1 1 1 1 1 1 1 1 1 1 1 1 1 1 1 1 1 1 1 1 1 4 2 2 2 2 2 2 2 2 2 2 2 2 2 2 2 4 1 1 1 1 1 1 1 1 1 1 1 1 1 1 1 1 1 1 1 1 1 1 1 1 1 1 1 1 1 1
1 1 1 1 1 1 1 1 1 1 1 1 1 1 1 1 1 1 1 1 1 1 1 1 1 1 1 1 1 1 4 2 2 2 2 2 2 2 2 2 2 2 2 2 2 2 4 1 1 1 1 1 1 1 1 1 1 1 1 1 1 1 1 1 1 1 1 1 1 1 1 1 1 1 1 1 1
1 1 1 1 1 1 1 1 1 1 1 1 1 1 1 1 1 1 1 1 1 1 1 1 1 1 1 1 1 1 4 2 2 2 2 2 2 2 2 2 2 2 2 2 2 2 4 1 1 1 1 1 1 1 1 1 1 1 1 1 1 1 1 1 1 1 1 1 1 1 1 1 1 1 1 1 1
1 1 1 1 1 1 1 1 1 1 1 1 1 1 1 1 1 1 1 1 1 1 1 1 1 1 1 1 1 1 4 2 2 2 2 2 2 2 2 2 2 2 2 2 2 2 4 1 1 1 1 1 1 1 1 1 1 1 1 1 1 1 1 1 1 1 1 1 1 1 1 1 1 1 1 1 1
1 1 1 1 1 1 1 1 1 1 1 1 1 1 1 1 1 1 1 1 1 1 1 1 1 1 1 1 1 1 4 4 4 4 4 4 4 4 3 4 4 4 4 4 4 4 4 1 1 1 1 1 1 1 1 1 1 1 1 1 1 1 1 1 1 1 1 1 1 1 1 1 1 1 1 1 1
1 1 1 1 1 1 1 1 1 1 1 1 1 1 1 1 1 1 1 1 1 1 1 1 1 1 1 1 1 1 1 1 1 1 1 1 1 8 8 8 1 1 1 1 1 1 1 1 1 1 1 1 1 1 1 1 1 1 1 1 1 1 1 1 1 1 1 1 1 1 1 1 1 1 1 1 1
1 1 1 1 1 1 1 1 1 1 1 1 1 1 1 1 1 1 1 1 1 1 1 1 1 1 1 1 1 1 1 1 1 1 1 1 1 6 6 6 1 1 1 1 1 1 1 1 1 1 1 1 1 1 1 1 1 1 1 1 1 1 1 1 1 1 1 1 1 1 1 1 1 1 1 1 1
1 1 1 1 1 1 1 1 1 1 1 1 1 1 1 1 1 1 1 1 1 1 1 1 1 1 1 1 1 1 1 1 1 1 1 1 1 6 6 6 1 1 1 1 1 1 1 1 1 1 1 1 1 1 1 1 1 1 1 1 1 1 1 1 1 1 1 1 1 1 1 1 1 1 1 1 1
1 1 1 1 1 1 1 1 1 1 1 1 1 1 1 1 1 1 1 1 1 1 1 1 1 1 1 1 1 1 1 1 1 1 1 1 1 6 6 6 1 1 1 1 1 1 1 1 1 1 1 1 1 1 1 1 1 1 1 1 1 1 1 1 1 1 1 1 1 1 1 1 1 1 1 1 1
1 1 1 1 1 1 1 1 1 1 1 1 1 1 1 1 1 1 1 1 1 1 1 1 1 1 1 1 1 1 1 1 1 1 1 1 1 6 6 6 1 1 1 1 1 1 1 1 1 1 1 1 1 1 1 1 1 1 1 1 1 1 1 1 1 1 1 1 1 1 1 1 1 1 1 1 1
1 1 1 1 1 1 1 1 1 1 1 1 1 1 1 1 1 1 1 1 1 1 1 1 1 1 1 1 1 1 1 1 1 1 1 1 1 9 9 9 1 1 1 1 1 1 1 1 1 1 1 1 1 1 1 1 1 1 1 1 1 1 1 1 1 1 1 1 1 1 1 1 1 1 1 1 1
1 1 1 1 1 1 1 4 4 4 4 4 4 4 4 4 4 4 4 4 4 4 4 4 1 1 1 1 1 1 4 4 4 4 4 4 4 4 3 4 4 4 4 4 4 4 4 1 1 1 1 1 1 4 4 4 4 4 4 4 4 4 4 4 4 4 4 4 4 4 1 1 1 1 1 1 1
1 1 1 1 1 1 1 4 12 12 12 12 12 12 12 12 12 12 17 18 17 17 17 4 1 1 1 1 1 1 4 2 2 2 2 2 2 0 0 0 2 2 2 2 2 2 4 1 1 1 1 1 1 4 2 2 2 2 2 2 2 2 2 2 2 2 2 2 2 4 1 1 1 1 1 1 1
1 1 1 1 1 1 1 4 14 12 21 13 13 13 13 12 12 12 12 12 12 12 17 4 1 1 1 1 1 1 4 2 2 2 2 2 2 0 0 0 2 2 2 2 2 2 4 1 1 1 1 1 1 4 2 2 2 2 2 2 2 2 2 2 2 2 2 2 2 4 1 1 1 1 1 1 1
1 1 1 1 1 1 1 4 17 12 21 21 21 21 13 12 12 12 12 17 17 12 18 4 1 1 1 1 1 1 4 2 2 2 2 2 2 0 0 0 2 2 2 2 2 2 4 1 1 1 1 1 1 4 2 2 2 2 2 2 2 2 2 2 2 2 2 2 2 4 1 1 1 1 1 1 1
1 1 1 1 1 1 1 4 17 12 21 14 14 21 21 12 12 12 12 17 17 12 17 4 1 1 1 1 1 1 4 2 2 2 2 2 2 0 0 0 2 2 2 2 2 2 4 1 1 1 1 1 1 4 2 2 2 2 2 2 2 2 2 2 2 2 2 2 2 4 1 1 1 1 1 1 1
1 1 1 1 1 1 1 4 17 12 21 21 21 21 21 12 12 12 12 17 17 12 17 4 1 1 1 1 1 1 4 2 2 2 2 2 2 0 0 0 2 2 2 2 2 2 4 1 1 1 1 1 1 4 2 2 2 2 2 2 2 2 2 2 2 2 2 2 2 4 1 1 1 1 1 1 1
1 1 1 1 1 1 1 4 14 12 21 13 21 13 21 12 12 12 12 12 12 12 18 4 1 1 1 1 1 1 4 2 2 2 2 2 2 0 0 0 2 2 2 2 2 2 4 1 1 1 1 1 1 4 2 2 2 2 2 2 2 2 2 2 2 2 2 2 2 4 1 1 1 1 1 1 1
1 1 1 1 1 1 1 4 12 12 12 12 12 12 12 12 12 12 15 15 15 15 15 4 10 7 7 7 7 11 4 0 0 0 0 0 0 0 0 0 0 0 0 0 0 0 4 10 7 7 7 7 11 4 2 2 2 2 2 2 2 2 2 2 2 2 2 2 2 4 1 1 1 1 1 1 1
1 1 1 1 1 1 1 4 12 12 12 15 12 15 12 12 12 12 12 12 12 12 12 3 10 7 7 7 7 11 3 0 0 0 0 0 0 0 0 0 0 0 0 0 0 0 3 10 7 7 7 7 11 3 2 2 2 2 2 2 2 2 2 2 2 2 2 2 2 4 1 1 1 1 1 1 1
1 1 1 1 1 1 1 4 12 12 14 14 14 14 14 12 12 12 15 15 15 15 15 4 10 7 7 7 7 11 4 0 0 0 0 0 0 0 0 0 0 0 0 0 0 0 4 10 7 7 7 7 11 4 2 2 2 2 2 2 2 2 2 2 2 2 2 2 2 4 1 1 1 1 1 1 1
1 1 1 1 1 1 1 4 12 12 14 14 14 14 14 12 12 12 15 16 17 17 17 4 1 1 1 1 1 1 4 2 2 2 2 2 2 0 0 0 2 2 2 2 2 2 4 1 1 1 1 1 1 4 2 2 2 2 2 2 2 2 2 2 2 2 2 2 2 4 1 1 1 1 1 1 1
1 1 1 1 1 1 1 4 12 12 12 15 12 15 12 12 12 12 12 16 16 16 16 4 1 1 1 1 1 1 4 2 2 2 2 2 2 0 0 0 2 2 2 2 2 2 4 1 1 1 1 1 1 4 2 2 2 2 2 2 2 2 2 2 2 2 2 2 2 4 1 1 1 1 1 1 1
1 1 1 1 1 1 1 4 12 12 12 12 12 12 12 12 12 12 15 17 16 18 18 4 1 1 1 1 1 1 4 2 2 2 2 2 2 0 0 0 2 2 2 2 2 2 4 1 1 1 1 1 1 4 2 2 2 2 2 2 2 2 2 2 2 2 2 2 2 4 1 1 1 1 1 1 1
1 1 1 1 1 1 1 4 15 15 15 15 12 15 15 15 12 15 15 15 15 15 15 4 1 1 1 1 1 1 4 2 2 2 2 2 2 0 0 0 2 2 2 2 2 2 4 1 1 1 1 1 1 4 2 2 2 2 2 2 2 2 2 2 2 2 2 2 2 4 1 1 1 1 1 1 1
1 1 1 1 1 1 1 4 12 12 12 12 12 12 15 12 12 12 14 14 14 12 14 4 1 1 1 1 1 1 4 2 2 2 2 2 2 0 0 0 2 2 2 2 2 2 4 1 1 1 1 1 1 4 2 2 2 2 2 2 2 2 2 2 2 2 2 2 2 4 1 1 1 1 1 1 1
1 1 1 1 1 1 1 4 12 20 20 20 20 14 15 12 12 12 12 13 12 12 14 4 1 1 1 1 1 1 4 2 2 2 2 2 2 0 0 0 2 2 2 2 2 2 4 1 1 1 1 1 1 4 2 2 2 2 2 2 2 2 2 2 2 2 2 2 2 4 1 1 1 1 1 1 1
1 1 1 1 1 1 1 4 12 20 21 21 20 14 15 12 12 12 12 12 12 12 14 4 1 1 1 1 1 1 4 2 2 2 2 2 2 0 0 0 2 2 2 2 2 2 4 1 1 1 1 1 1 4 2 2 2 2 2 2 2 2 2 2 2 2 2 2 2 4 1 1 1 1 1 1 1
1 1 1 1 1 1 1 4 12 20 20 20 20 14 15 12 12 12 13 13 13 12 12 4 1 1 1 1 1 1 4 2 2 2 2 2 2 0 0 0 2 2 2 2 2 2 4 1 1 1 1 1 1 4 2 2 2 2 2 2 2 2 2 2 2 2 2 2 2 4 1 1 1 1 1 1 1
1 1 1 1 1 1 1 4 12 12 12 12 12 12 15 14 12 12 13 13 13 12 12 4 1 1 1 1 1 1 4 2 2 2 2 2 2 0 0 0 2 2 2 2 2 2 4 1 1 1 1 1 1 4 2 2 2 2 2 2 2 2 2 2 2 2 2 2 2 4 1 1 1 1 1 1 1
1 1 1 1 1 1 1 4 14 12 13 13 13 19 15 14 12 12 13 13 13 12 12 4 1 1 1 1 1 1 4 2 2 2 2 2 2 0 0 0 2 2 2 2 2 2 4 1 1 1 1 1 1 4 2 2 2 2 2 2 2 2 2 2 2 2 2 2 2 4 1 1 1 1 1 1 1
1 1 1 1 1 1 1 4 14 12 13 13 13 19 15 14 12 14 19 19 19 14 12 4 1 1 1 1 1 1 4 2 2 2 2 2 2 0 0 0 2 2 2 2 2 2 4 1 1 1 1 1 1 4 2 2 2 2 2 2 2 2 2 2 2 2 2 2 2 4 1 1 1 1 1 1 1
1 1 1 1 1 1 1 4 4 4 4 4 4 4 4 4 4 4 4 4 4 4 4 4 1 1 1 1 1 1 4 4 4 4 4 4 4 4 3 4 4 4 4 4 4 4 4 1 1 1 1 1 1 4 4 4 4 4 4 4 4 4 4 4 4 4 4 4 4 4 1 1 1 1 1 1 1
1 1 1 1 1 1 1 1 1 1 1 1 1 1 1 1 1 1 1 1 1 1 1 1 1 1 1 1 1 1 1 1 1 1 1 1 1 1 1 1 1 1 1 1 1 1 1 1 1 1 1 1 1 1 1 1 1 1 1 1 1 1 1 1 1 1 1 1 1 1 1 1 1 1 1 1 1
1 1 1 1 1 1 1 1 1 1 1 1 1 1 1 1 1 1 1 1 1 1 1 1 1 1 1 1 1 1 1 1 1 1 1 1 1 1 1 1 1 1 1 1 1 1 1 1 1 1 1 1 1 1 1 1 1 1 1 1 1 1 1 1 1 1 1 1 1 1 1 1 1 1 1 1 1
1 1 1 1 1 1 1 1 1 1 1 1 1 1 1 1 1 1 1 1 1 1 1 1 1 1 1 1 1 1 1 1 1 1 1 1 1 1 1 1 1 1 1 1 1 1 1 1 1 1 1 1 1 1 1 1 1 1 1 1 1 1 1 1 1 1 1 1 1 1 1 1 1 1 1 1 1
1 1 1 1 1 1 1 1 1 1 1 1 1 1 1 1 1 1 1 1 1 1 1 1 1 1 1 1 1 1 1 1 1 1 1 1 1 1 1 1 1 1 1 1 1 1 1 1 1 1 1 1 1 1 1 1 1 1 1 1 1 1 1 1 1 1 1 1 1 1 1 1 1 1 1 1 1
1 1 1 1 1 1 1 1 1 1 1 1 1 1 1 1 1 1 1 1 1 1 1 1 1 1 1 1 1 1 1 1 1 1 1 1 1 1 1 1 1 1 1 1 1 1 1 1 1 1 1 1 1 1 1 1 1 1 1 1 1 1 1 1 1 1 1 1 1 1 1 1 1 1 1 1 1
1 1 1 1 1 1 1 1 1 1 1 1 1 1 1 1 1 1 1 1 1 1 1 1 1 1 1 1 1 1 1 1 1 1 1 1 1 1 1 1 1 1 1 1 1 1 1 1 1 1 1 1 1 1 1 1 1 1 1 1 1 1 1 1 1 1 1 1 1 1 1 1 1 1 1 1 1
