1 1 1 1 1 1 1 1 1 1 1 1 1 1 1 1 1 1 1 1 1 1 1 1 1 1 1 1 1 1 1 1 1 1 1 1 1 1 1 1 1 1 1 1 1 1 1 1 1 1 1 1 1 1 1 1 1 1 1 1 1 1 1 1 1 1 1 1 1 1 1 1 1 1 1 1 1
1 1 1 1 1 1 1 1 1 1 1 1 1 1 1 1 1 1 1 1 1 1 1 1 1 1 1 1 1 1 1 1 1 1 1 1 1 1 1 1 1 1 1 1 1 1 1 1 1 1 1 1 1 1 1 1 1 1 1 1 1 1 1 1 1 1 1 1 1 1 1 1 1 1 1 1 1
1 1 1 1 1 1 1 1 1 1 1 1 1 1 1 1 1 1 1 1 1 1 1 1 1 1 1 1 1 1 1 1 1 1 1 1 1 1 1 1 1 1 1 1 1 1 1 1 1 1 1 1 1 1 1 1 1 1 1 1 1 1 1 1 1 1 1 1 1 1 1 1 1 1 1 1 1
1 1 1 1 1 1 1 1 1 1 1 1 1 1 1 1 1 1 1 1 1 1 1 1 1 1 1 1 1 1 1 1 1 1 1 1 1 1 1 1 1 1 1 1 1 1 1 1 1 1 1 1 1 1 1 1 1 1 1 1 1 1 1 1 1 1 1 1 1 1 1 1 1 1 1 1 1
1 1 1 1 1 1 1 1 1 1 1 1 1 1 1 1 1 1 1 1 1 1 1 1 1 1 1 1 1 1 1 1 1 1 1 1 1 1 1 1 1 1 1 1 1 1 1 1 1 1 1 1 1 1 1 1 1 1 1 1 1 1 1 1 1 1 1 1 1 1 1 1 1 1 1 1 1
1 1 1 1 1 1 1 1 1 1 1 1 1 1 1 1 1 1 1 1 1 1 1 1 1 1 1 1 1 1 4 4 4 4 4 4 4 4 4 4 4 4 4 4 4 4 4 1 1 1 1 1 1 1 1 1 1 1 1 1 1 1 1 1 1 1 1 1 1 1 1 1 1 1 1 1 1
1 1 1 1 1 1 1 1 1 1 1 1 1 1 1 1 1 1 1 1 1 1 1 1 1 1 1 1 1 1 4 2 2 2 2 2 2 2 2 2 2 2 2 2 2 2 4 1 1 1 1 1 1 1 1 1 1 1 1 1 1 1 1 1 1 1 1 1 1 1 1 1 1 1 1 1 1
1 1 1 1 1 1 1 1 1 1 1 1 1 1 1 1 1 1 1 1 1 1 1 1 1 1 1 1 1 1 4 2 2 2 2 2 2 2 2 2 2 2 2 2 2 2 4 1 1 1 1 1 1 1 1 1 1 1 1 1 1 1 1 1 1 1 1 1 1 1 1 1 1 1 1 1 1
1 1 1 1 1 1 1 1 1 1 1 1 1 1 1 1 1 1 1 1 1 1 1 1 1 1 1 1 1 1 4 2 2 2 2 2 2 2 2 2 2 2 2 2 2 2 4 1 1 1 1 1 1 1 1 1 1 1 1 1 1 1 1 1 1 1 1 1 1 1 1 1 1 1 1 1 1
1 1 1 1 1 1 1 1 1 1 1 1 1 1 1 1 1 1 1 1 1 1 1 1 1 1 1 1 1 1 4 2 2 2 2 2 2 2 2 2 2 2 2 2 2 2 4 1 1 1 1 1 1 1 1 1 1 1 1 1 1 1 1 1 1 1 1 1 1 1 1 1 1 1 1 1 1
1 1 1 1 1 1 1 1 1 1 1 1 1 1 1 1 1 1 1 1 1 1 1 1 1 1 1 1 1 1 4 2 2 2 2 2 2 2 2 2 2 2 2 2 2 2 4 1 1 1 1 1 1 1 1 1 1 1 1 1 1 1 1 1 1 1 1 1 1 1 1 1 1 1 1 1 1
1 1 1 1 1 1 1 1 1 1 1 1 1 1 1 1 1 1 1 1 1 1 1 1 1 1 1 1 1 1 4 2 2 2 2 2 2 2 2 2 2 2 2 2 2 2 4 1 1 1 1 1 1 1 1 1 1 1 1 1 1 1 1 1 1 1 1 1 1 1 1 1 1 1 1 1 1
1 1 1 1 1 1 1 1 1 1 1 1 1 1 1 1 1 1 1 1 1 1 1 1 1 1 1 1 1 1 4 2 2 2 2 2 2 2 2 2 2 2 2 2 2 2 4 1 1 1 1 1 1 1 1 1 1 1 1 1 1 1 1 1 1 1 1 1 1 1 1 1 1 1 1 1 1
1 1 1 1 1 1 1 1 1 1 1 1 1 1 1 1 1 1 1 1 1 1 1 1 1 1 1 1 1 1 4 2 2 2 2 2 2 2 2 2 2 2 2 2 2 2 4 1 1 1 1 1 1 1 1 1 1 1 1 1 1 1 1 1 1 1 1 1 1 1 1 1 1 1 1 1 1
1 1 1 1 1 1 1 1 1 1 1 1 1 1 1 1 1 1 1 1 1 1 1 1 1 1 1 1 1 1 4 2 2 2 2 2 2 2 2 2 2 2 2 2 2 2 4 1 1 1 1 1 1 1 1 1 1 1 1 1 1 1 1 1 1 1 1 1 1 1 1 1 1 1 1 1 1
1 1 1 1 1 1 1 1 1 1 1 1 1 1 1 1 1 1 1 1 1 1 1 1 1 1 1 1 1 1 4 2 2 2 2 2 2 2 2 2 2 2 2 2 2 2 4 1 1 1 1 1 1 1 1 1 1 1 1 1 1 1 1 1 1 1 1 1 1 1 1 1 1 1 1 1 1
1 1 1 1 1 1 1 1 1 1 1 1 1 1 1 1 1 1 1 1 1 1 1 1 1 1 1 1 1 1 4 2 2 2 2 2 2 2 2 2 2 2 2 2 2 2 4 1 1 1 1 1 1 1 1 1 1 1 1 1 1 1 1 1 1 1 1 1 1 1 1 1 1 1 1 1 1
1 1 1 1 1 1 1 1 1 1 1 1 1 1 1 1 1 1 1 1 1 1 1 1 1 1 1 1 1 1 4 2 2 2 2 2 2 2 2 2 2 2 2 2 2 2 4 1 1 1 1 1 1 1 1 1 1 1 1 1 1 1 1 1 1 1 1 1 1 1 1 1 1 1 1 1 1
1 1 1 1 1 1 1 1 1 1 1 1 1 1 1 1 1 1 1 1 1 1 1 1 1 1 1 1 1 1 4 2 2 2 2 2 2 2 2 2 2 2 2 2 2 2 4 1 1 1 1 1 1 1 1 1 1 1 1 1 1 1 1 1 1 1 1 1 1 1 1 1 1 1 1 1 1
1 1 1 1 1 1 1 1 1 1 1 1 1 1 1 1 1 1 1 1 1 1 1 1 1 1 1 1 1 1 4 2 2 2 2 2 2 2 2 2 2 2 2 2 2 2 4 1 1 1 1 1 1 1 1 1 1 1 1 1 1 1 1 1 1 1 1 1 1 1 1 1 1 1 1 1 1
1 1 1 1 1 1 1 1 1 1 1 1 1 1 1 1 1 1 1 1 1 1 1 1 1 1 1 1 1 1 4 2 2 2 2 2 2 2 2 2 2 2 2 2 2 2 4 1 1 1 1 1 1 1 1 1 1 1 1 1 1 1 1 1 1 1 1 1 1 1 1 1 1 1 1 1 1
1 1 1 1 1 1 1 1 1 1 1 1 1 1 1 1 1 1 1 1 1 1 1 1 1 1 1 1 1 1 4 2 2 2 2 2 2 2 2 2 2 2 2 2 2 2 4 1 1 1 1 1 1 1 1 1 1 1 1 1 1 1 1 1 1 1 1 1 1 1 1 1 1 1 1 1 1
1 1 1 1 1 1 1 1 1 1 1 1 1 1 1 1 1 1 1 1 1 1 1 1 1 1 1 1 1 1 4 2 2 2 2 2 2 2 2 2 2 2 2 2 2 2 4 1 1 1 1 1 1 1 1 1 1 1 1 1 1 1 1 1 1 1 1 1 1 1 1 1 1 1 1 1 1
1 1 1 1 1 1 1 1 1 1 1 1 1 1 1 1 1 1 1 1 1 1 1 1 1 1 1 1 1 1 4 2 2 2 2 2 2 2 2 2 2 2 2 2 2 2 4 1 1 1 1 1 1 1 1 1 1 1 1 1 1 1 1 1 1 1 1 1 1 1 1 1 1 1 1 1 1
1 1 1 1 1 1 1 1 1 1 1 1 1 1 1 1 1 1 1 1 1 1 1 1 1 1 1 1 1 1 4 2 2 2 2 2 2 2 2 2 2 2 2 2 2 2 4 1 1 1 1 1 1 1 1 1 1 1 1 1 1 1 1 1 1 1 1 1 1 1 1 1 1 1 1 1 1
1 1 1 1 1 1 1 1 1 1 1 1 1 1 1 1 1 1 1 1 1 1 1 1 1 1 1 1 1 1 4 2 2 2 2 2 2 2 2 2 2 2 2 2 2 2 4 1 1 1 1 1 1 1 1 1 1 1 1 1 1 1 1 1 1 1 1 1 1 1 1 1 1 1 1 1 1
1 1 1 1 1 1 1 1 1 1 1 1 1 1 1 1 1 1 1 1 1 1 1 1 1 1 1 1 1 1 4 4 4 4 4 4 4 4 3 4 4 4 4 4 4 4 4 1 1 1 1 1 1 1 1 1 1 1 1 1 1 1 1 1 1 1 1 1 1 1 1 1 1 1 1 1 1
1 1 1 1 1 1 1 1 1 1 1 1 1 1 1 1 1 1 1 1 1 1 1 1 1 1 1 1 1 1 1 1 1 1 1 1 1 8 8 8 1 1 1 1 1 1 1 1 1 1 1 1 1 1 1 1 1 1 1 1 1 1 1 1 1 1 1 1 1 1 1 1 1 1 1 1 1
1 1 1 1 1 1 1 1 1 1 1 1 1 1 1 1 1 1 1 1 1 1 1 1 1 1 1 1 1 1 1 1 1 1 1 1 1 6 6 6 1 1 1 1 1 1 1 1 1 1 1 1 1 1 1 1 1 1 1 1 1 1 1 1 1 1 1 1 1 1 1 1 1 1 1 1 1
1 1 1 1 1 1 1 1 1 1 1 1 1 1 1 1 1 1 1 1 1 1 1 1 1 1 1 1 1 1 1 1 1 1 1 1 1 6 6 6 1 1 1 1 1 1 1 1 1 1 1 1 1 1 1 1 1 1 1 1 1 1 1 1 1 1 1 1 1 1 1 1 1 1 1 1 1
1 1 1 1 1 1 1 1 1 1 1 1 1 1 1 1 1 1 1 1 1 1 1 1 1 1 1 1 1 1 1 1 1 1 1 1 1 6 6 6 1 1 1 1 1 1 1 1 1 1 1 1 1 1 1 1 1 1 1 1 1 1 1 1 1 1 1 1 1 1 1 1 1 1 1 1 1
1 1 1 1 1 1 1 1 1 1 1 1 1 1 1 1 1 1 1 1 1 1 1 1 1 1 1 1 1 1 1 1 1 1 1 1 1 6 6 6 1 1 1 1 1 1 1 1 1 1 1 1 1 1 1 1 1 1 1 1 1 1 1 1 1 1 1 1 1 1 1 1 1 1 1 1 1
1 1 1 1 1 1 1 1 1 1 1 1 1 1 1 1 1 1 1 1 1 1 1 1 1 1 1 1 1 1 1 1 1 1 1 1 1 9 9 9 1 1 1 1 1 1 1 1 1 1 1 1 1 1 1 1 1 1 1 1 1 1 1 1 1 1 1 1 1 1 1 1 1 1 1 1 1
1 1 1 1 1 1 1 4 4 4 4 4 4 4 4 4 4 4 4 4 4 4 4 4 1 1 1 1 1 1 4 4 4 4 4 4 4 4 3 4 4 4 4 4 4 4 4 1 1 1 1 1 1 4 4 4 4 4 4 4 4 4 4 4 4 4 4 4 4 4 1 1 1 1 1 1 1
1 1 1 1 1 1 1 4 2 2 2 2 2 2 2 2 2 2 2 2 2 2 2 4 1 1 1 1 1 1 4 2 2 2 2 2 2 0 0 0 2 2 2 2 2 2 4 1 1 1 1 1 1 4 2 2 2 2 2 2 2 2 2 2 2 2 2 2 2 4 1 1 1 1 1 1 1
1 1 1 1 1 1 1 4 2 2 2 2 2 2 2 2 2 2 2 2 2 2 2 4 1 1 1 1 1 1 4 2 2 2 2 2 2 0 0 0 2 2 2 2 2 2 4 1 1 1 1 1 1 4 2 2 2 2 2 2 2 2 2 2 2 2 2 2 2 4 1 1 1 1 1 1 1
1 1 1 1 1 1 1 4 2 2 2 2 2 2 2 2 2 2 2 2 2 2 2 4 1 1 1 1 1 1 4 2 2 2 2 2 2 0 0 0 2 2 2 2 2 2 4 1 1 1 1 1 1 4 2 2 2 2 2 2 2 2 2 2 2 2 2 2 2 4 1 1 1 1 1 1 1
1 1 1 1 1 1 1 4 2 2 2 2 2 2 2 2 2 2 2 2 2 2 2 4 1 1 1 1 1 1 4 2 2 2 2 2 2 0 0 0 2 2 2 2 2 2 4 1 1 1 1 1 1 4 2 2 2 2 2 2 2 2 2 2 2 2 2 2 2 4 1 1 1 1 1 1 1
1 1 1 1 1 1 1 4 2 2 2 2 2 2 2 2 2 2 2 2 2 2 2 4 1 1 1 1 1 1 4 2 2 2 2 2 2 0 0 0 2 2 2 2 2 2 4 1 1 1 1 1 1 4 2 2 2 2 2 2 2 2 2 2 2 2 2 2 2 4 1 1 1 1 1 1 1
1 1 1 1 1 1 1 4 2 2 2 2 2 2 2 2 2 2 2 2 2 2 2 4 1 1 1 1 1 1 4 2 2 2 2 2 2 0 0 0 2 2 2 2 2 2 4 1 1 1 1 1 1 4 2 2 2 2 2 2 2 2 2 2 2 2 2 2 2 4 1 1 1 1 1 1 1
1 1 1 1 1 1 1 4 2 2 2 2 2 2 2 2 2 2 2 2 2 2 2 4 10 7 7 7 7 11 4 0 0 0 0 0 0 0 0 0 0 0 0 0 0 0 4 10 7 7 7 7 11 4 2 2 2 2 2 2 2 2 2 2 2 2 2 2 2 4 1 1 1 1 1 1 1
1 1 1 1 1 1 1 4 2 2 2 2 2 2 2 2 2 2 2 2 2 2 2 3 10 7 7 7 7 11 3 0 0 0 0 0 0 0 0 0 0 0 0 0 0 0 3 10 7 7 7 7 11 3 2 2 2 2 2 2 2 2 2 2 2 2 2 2 2 4 1 1 1 1 1 1 1
1 1 1 1 1 1 1 4 2 2 2 2 2 2 2 2 2 2 2 2 2 2 2 4 10 7 7 7 7 11 4 0 0 0 0 0 0 0 0 0 0 0 0 0 0 0 4 10 7 7 7 7 11 4 2 2 2 2 2 2 2 2 2 2 2 2 2 2 2 4 1 1 1 1 1 1 1
1 1 1 1 1 1 1 4 2 2 2 2 2 2 2 2 2 2 2 2 2 2 2 4 1 1 1 1 1 1 4 2 2 2 2 2 2 0 0 0 2 2 2 2 2 2 4 1 1 1 1 1 1 4 2 2 2 2 2 2 2 2 2 2 2 2 2 2 2 4 1 1 1 1 1 1 1
1 1 1 1 1 1 1 4 2 2 2 2 2 2 2 2 2 2 2 2 2 2 2 4 1 1 1 1 1 1 4 2 2 2 2 2 2 0 0 0 2 2 2 2 2 2 4 1 1 1 1 1 1 4 2 2 2 2 2 2 2 2 2 2 2 2 2 2 2 4 1 1 1 1 1 1 1
1 1 1 1 1 1 1 4 2 2 2 2 2 2 2 2 2 2 2 2 2 2 2 4 1 1 1 1 1 1 4 2 2 2 2 2 2 0 0 0 2 2 2 2 2 2 4 1 1 1 1 1 1 4 2 2 2 2 2 2 2 2 2 2 2 2 2 2 2 4 1 1 1 1 1 1 1
1 1 1 1 1 1 1 4 2 2 2 2 2 2 2 2 2 2 2 2 2 2 2 4 1 1 1 1 1 1 4 2 2 2 2 2 2 0 0 0 2 2 2 2 2 2 4 1 1 1 1 1 1 4 2 2 2 2 2 2 2 2 2 2 2 2 2 2 2 4 1 1 1 1 1 1 1
1 1 1 1 1 1 1 4 2 2 2 2 2 2 2 2 2 2 2 2 2 2 2 4 1 1 1 1 1 1 4 2 2 2 2 2 2 0 0 0 2 2 2 2 2 2 4 1 1 1 1 1 1 4 2 2 2 2 2 2 2 2 2 2 2 2 2 2 2 4 1 1 1 1 1 1 1
1 1 1 1 1 1 1 4 2 2 2 2 2 2 2 2 2 2 2 2 2 2 2 4 1 1 1 1 1 1 4 2 2 2 2 2 2 0 0 0 2 2 2 2 2 2 4 1 1 1 1 1 1 4 2 2 2 2 2 2 2 2 2 2 2 2 2 2 2 4 1 1 1 1 1 1 1
1 1 1 1 1 1 1 4 2 2 2 2 2 2 2 2 2 2 2 2 2 2 2 4 1 1 1 1 1 1 4 2 2 2 2 2 2 0 0 0 2 2 2 2 2 2 4 1 1 1 1 1 1 4 2 2 2 2 2 2 2 2 2 2 2 2 2 2 2 4 1 1 1 1 1 1 1
1 1 1 1 1 1 1 4 2 2 2 2 2 2 2 2 2 2 2 2 2 2 2 4 1 1 1 1 1 1 4 2 2 2 2 2 2 0 0 0 2 2 2 2 2 2 4 1 1 1 1 1 1 4 2 2 2 2 2 2 2 2 2 2 2 2 2 2 2 4 1 1 1 1 1 1 1
1 1 1 1 1 1 1 4 2 2 2 2 2 2 2 2 2 2 2 2 2 2 2 4 1 1 1 1 1 1 4 2 2 2 2 2 2 0 0 0 2 2 2 2 2 2 4 1 1 1 1 1 1 4 2 2 2 2 2 2 2 2 2 2 2 2 2 2 2 4 1 1 1 1 1 1 1
1 1 1 1 1 1 1 4 2 2 2 2 2 2 2 2 2 2 2 2 2 2 2 4 1 1 1 1 1 1 4 2 2 2 2 2 2 0 0 0 2 2 2 2 2 2 4 1 1 1 1 1 1 4 2 2 2 2 2 2 2 2 2 2 2 2 2 2 2 4 1 1 1 1 1 1 1
1 1 1 1 1 1 1 4 2 2 2 2 2 2 2 2 2 2 2 2 2 2 2 4 1 1 1 1 1 1 4 2 2 2 2 2 2 0 0 0 2 2 2 2 2 2 4 1 1 1 1 1 1 4 2 2 2 2 2 2 2 2 2 2 2 2 2 2 2 4 1 1 1 1 1 1 1
1 1 1 1 1 1 1 4 4 4 4 4 4 4 4 4 4 4 4 4 4 4 4 4 1 1 1 1 1 1 4 4 4 4 4 4 4 3 3 3 4 4 4 4 4 4 4 1 1 1 1 1 1 4 4 4 4 4 4 4 4 4 4 4 4 4 4 4 4 4 1 1 1 1 1 1 1
1 1 1 1 1 1 1 1 1 1 1 1 1 1 1 1 1 1 1 1 1 1 1 1 1 1 1 1 1 1 1 1 1 1 1 1 1 1 1 1 1 1 1 1 1 1 1 1 1 1 1 1 1 1 1 1 1 1 1 1 1 1 1 1 1 1 1 1 1 1 1 1 1 1 1 1 1
1 1 1 1 1 1 1 1 1 1 1 1 1 1 1 1 1 1 1 1 1 1 1 1 1 1 1 1 1 1 1 1 1 1 1 1 1 1 1 1 1 1 1 1 1 1 1 1 1 1 1 1 1 1 1 1 1 1 1 1 1 1 1 1 1 1 1 1 1 1 1 1 1 1 1 1 1
1 1 1 1 1 1 1 1 1 1 1 1 1 1 1 1 1 1 1 1 1 1 1 1 1 1 1 1 1 1 1 1 1 1 1 1 1 1 1 1 1 1 1 1 1 1 1 1 1 1 1 1 1 1 1 1 1 1 1 1 1 1 1 1 1 1 1 1 1 1 1 1 1 1 1 1 1
1 1 1 1 1 1 1 1 1 1 1 1 1 1 1 1 1 1 1 1 1 1 1 1 1 1 1 1 1 1 1 1 1 1 1 1 1 1 1 1 1 1 1 1 1 1 1 1 1 1 1 1 1 1 1 1 1 1 1 1 1 1 1 1 1 1 1 1 1 1 1 1 1 1 1 1 1
1 1 1 1 1 1 1 1 1 1 1 1 1 1 1 1 1 1 1 1 1 1 1 1 1 1 1 1 1 1 1 1 1 1 1 1 1 1 1 1 1 1 1 1 1 1 1 1 1 1 1 1 1 1 1 1 1 1 1 1 1 1 1 1 1 1 1 1 1 1 1 1 1 1 1 1 1
1 1 1 1 1 1 1 1 1 1 1 1 1 1 1 1 1 1 1 1 1 1 1 1 1 1 1 1 1 1 1 1 1 1 1 1 1 1 1 1 1 1 1 1 1 1 1 1 1 1 1 1 1 1 1 1 1 1 1 1 1 1 1 1 1 1 1 1 1 1 1 1 1 1 1 1 1
